{
	"rows": [
		{
			"row": ["1", "2", "3", "4", "4", "3", "2", "1"]
		},          
		{           
			"row": ["1", "2", "4", "2", "2", "3", "2", "3"]
		},
		{ 
			"row": ["2", "3", "4", "2", "3", "2", "3", "3"]
		},
		{ 
			"row": ["1", "3", "4", "1", "1", "2", "1", "2"]
		},
		{ 
			"row": ["2", "2", "1", "1", "2", "1", "2", "3"]
		},          
		{           
			"row": ["2", "3", "4", "2", "3", "2", "1", "2"]
		}
	]
}